2
2
2 1
16 16
- 0 0 0 0 0 0 0 0 0 0 0 0 0 0 -
- - 0 0 0 0 0 0 0 0 0 0 0 0 - -
- - - 0 0 0 0 0 0 0 0 0 0 - - -
- - 0 0 0 0 0 0 0 0 0 0 0 0 - -
- 0 0 0 0 0 0 0 0 0 0 0 0 0 0 -
0 0 0 0 0 0 0 0 0 0 0 0 0 0 0 0
- 0 0 0 0 0 0 0 0 0 0 0 0 0 0 -
- - 0 0 0 0 1 2 0 0 0 0 0 0 - -
- 0 0 0 0 0 2 1 0 0 0 0 0 0 0 -
- - 0 0 0 0 0 0 0 0 0 0 0 0 0 0
0 0 0 0 0 0 0 0 0 0 0 0 0 0 - -
0 0 0 0 0 0 0 0 0 0 0 0 0 - - -
- 0 0 0 0 0 0 0 0 0 0 0 - - - -
- - 0 0 0 0 0 0 0 0 0 - - - - -
- - 0 0 0 0 0 0 0 0 0 0 0 0 0 -
- - - 0 0 0 0 0 0 0 0 0 0 0 - -
1 0 0 <-> 13 15 4
14 0 0 <-> 4 5 4