3
25
3 2
20 20
- - - - 0 0 0 0 0 0 0 0 0 0 0 - - - - -
- - 0 0 0 0 0 - - 0 0 0 0 0 - - 0 0 0 -
- - - 0 0 0 0 - - 0 0 0 0 - - - - 0 0 0
- - 0 0 0 0 0 0 0 0 0 0 0 0 - - 0 0 - -
- 0 0 0 0 0 0 0 0 0 c 0 0 0 0 - - - 0 0
- - - - 0 0 0 0 0 0 0 0 0 0 0 0 - 0 0 -
- 0 0 0 0 0 0 0 0 0 0 0 0 0 0 0 0 0 0 0
- - 0 0 0 0 1 2 3 0 0 0 0 0 - - - - - -
- 0 0 0 0 0 2 1 2 0 0 0 0 0 0 - 0 0 0 0
- - 0 0 0 0 3 3 1 0 0 0 0 0 0 0 0 0 0 0
0 0 0 0 0 0 0 0 0 0 0 0 0 0 - - - 0 0 0
0 0 0 x x 0 0 0 0 0 0 0 0 - - - 0 0 0 -
- 0 0 0 x 0 0 0 0 0 0 0 - - - - - - - -
- - 0 0 x x x x 0 0 0 - - 0 0 0 0 - - -
- - 0 0 0 0 0 0 0 0 0 0 0 0 0 - 0 0 0 0
- - - 0 0 0 0 0 0 0 0 0 0 0 - - 0 0 0 -
- - - - 0 0 - - 0 0 - - - 0 0 0 0 0 - -
- - 0 0 0 0 0 0 0 0 0 - - - - - 0 - - -
- - 0 0 0 0 0 0 0 0 0 - - - - - - - - -
- - 0 0 0 0 0 0 0 0 c - - - - - - - - -
5 0 0 <-> 3 19 0
10 0 0 <-> 8 19 4