8
5
2 2
45 49
- - - - - - - - - - - - - - - - - - - - - - - - - - - - - - - - - - - - - - - - - - - - - - - - -
- - - - - - - - - - - - - - - - - - - - - - - - - - - - - - - - - - - - - - - - - - - - - - - - b
- - - - - - - - - - - - - - - - - - - - - - - - - - - - - - - - - - - - - - - - - - - - - 0 0 0 b
- - - - - - - - - - - - - - - - - - - - - - - - - - - - - - - - - - - - - - - - - - - - 0 - 0 - -
- - - - - - - - - - - - - - - - - - - - - - - - - - - - - - - - - - - - - - - - - - 0 - 0 0 - 0 -
- - - - - - - - - - - - - - - - - - - - - - - - - - - - - - - - - - - - - - - - 0 - 0 0 0 0 - - b
- - - - - - - - - - - - - - - - - - - - - - - - - - - - - - - - - - - - - b - - 0 0 0 0 0 - 0 - -
- - - - - - - - - - - - - - - - - - - - - - - - - - - - - - - - - - - - 0 - 0 0 0 0 0 0 0 0 - - -
- - - - - - - - - - - - - - - - - - - - - - - - - - - 0 b - - - - - - - 0 0 0 0 0 0 0 0 0 0 - - -
- - - - - - - - - - - - - - - - - - - - - - - - - - 0 0 0 - - - - - 0 0 0 0 0 0 0 0 0 0 0 - - - -
- - - - - - - - - - - - - - - - - - - - - - - - - - - - - - - - 0 0 0 0 0 0 0 0 0 0 0 0 - - - - -
- - - - - - - - - - - - - - - - - - - - - - - - b 0 - - - - 0 0 0 0 0 0 0 0 0 0 0 0 0 - - - - - -
- - - - - - - - - - - - - - - - - - - - - - - 0 0 b - - - 0 0 0 0 0 0 c b 0 0 0 0 0 - b - - - - -
- - - - - - - - - - - - - - - - - - - - - - 0 0 b - - 0 0 0 0 0 0 0 0 c b 0 0 0 0 - b - - - - - -
- - - - - - - - - - - - - - - - - - - - 0 0 0 0 - - 0 0 0 0 0 0 0 0 0 0 0 0 0 - 0 0 - - - - - - -
- - - - - - - - - - - - - - - - - - 0 0 0 0 - - 0 0 0 0 0 0 0 0 0 0 0 0 0 0 - 0 0 - - - - - - - -
- - - - - - - - - - - - - - - - - 0 0 0 - - 0 0 0 0 0 0 0 0 0 0 0 0 0 0 0 0 0 0 - - - - - - - - -
- - - - - - - - - - - - - - - 0 0 0 0 - - 0 0 0 0 0 0 0 0 0 b b 0 0 0 0 - 0 0 - - - - - - - - - -
- - - - - - - - - - - - - - 0 0 0 0 - 0 0 0 0 0 0 0 0 0 0 0 c c 0 0 0 0 0 0 - - - - - - - - - - -
- - - - - - - - - - 0 0 0 0 0 0 0 0 0 0 0 0 c b 0 0 0 0 0 0 0 0 0 0 - 0 0 - - - - - - - - - - - -
- - - - - - - - 0 0 0 0 0 0 0 0 0 0 0 0 0 0 c b 0 0 0 0 0 0 0 0 0 - 0 0 - - - - - - - - - - - - -
- - - - - - 0 0 0 0 0 - - - - 0 0 0 0 0 0 0 0 0 0 0 0 0 0 0 0 0 - 0 0 - b - - - - - - - - - - - -
- - - - - 0 0 0 0 - - - - - - - 0 0 0 0 0 0 0 0 0 0 0 0 0 0 0 0 0 0 - 0 b - - - - - - - - - - - -
- - - - 0 0 0 - - - - - - 0 0 0 0 0 0 0 0 0 0 0 0 0 0 0 0 0 - - - 0 0 0 - - - - - - - - - - - - -
- - - 0 0 0 - - 0 0 0 0 0 0 0 0 0 0 0 0 0 0 0 0 0 0 0 0 0 - 0 - 0 0 0 - - - - - - - - - - - - - -
- - 0 0 0 - - 0 0 0 0 0 0 0 0 0 0 0 0 0 0 0 0 0 b b 0 0 0 - 0 0 0 - - - - - - - - - - - - - - - -
- - 0 0 0 0 0 0 0 0 0 0 0 0 0 0 0 0 0 0 0 0 0 0 c c 0 0 - 0 0 0 - - - - - - - - - - - - - - - - -
- 0 0 0 0 0 0 0 0 0 0 0 0 0 0 0 0 0 0 0 0 0 0 0 0 0 0 0 0 0 - - - - - - - - - - - - - - - - - - -
- 0 0 0 0 0 0 0 0 0 0 0 0 0 0 0 0 0 0 0 0 0 0 0 0 0 0 0 0 - - - - - - - - - - - - - - - - - - - -
0 0 0 0 0 0 0 0 0 0 0 0 0 0 0 0 0 0 0 0 0 0 0 0 0 0 0 0 - - - - - - - - - - - - - - - - - - - - -
0 0 0 1 2 0 0 0 0 0 0 0 0 0 0 0 0 0 0 0 0 0 0 0 0 0 0 - - - - - - - - - - - - - - - - - - - - - -
0 0 0 2 1 0 0 0 0 0 0 0 0 0 0 0 0 0 0 0 0 0 0 0 0 0 - - - - - - - - - - - - - - - - - - - - - - -
0 0 0 0 0 0 0 0 0 0 0 0 0 0 0 0 0 0 0 0 0 0 0 0 0 0 - - - - - - - - - - - - - - - - - - - - - - -
0 0 0 0 0 0 0 0 0 0 0 0 0 0 0 0 0 0 0 0 0 0 0 0 0 0 - - - - - - - - - - - - - - - - - - - - - - -
0 0 0 0 0 0 0 0 0 0 0 0 0 0 0 0 0 0 0 0 0 0 0 0 0 0 - - - - - - - - - - - - - - - - - - - - - - -
- 0 0 0 0 3 4 0 0 0 0 0 0 0 0 0 0 0 0 0 0 0 0 0 0 - - - - - - - - - - - - - - - - - - - - - - - -
- 0 0 0 0 4 3 0 0 0 0 0 0 0 0 0 0 0 0 0 0 0 0 0 0 - - - - - - - - - - - - - - - - - - - - - - - -
- - 0 0 0 0 0 0 0 0 0 0 0 0 0 0 0 0 0 0 0 0 0 0 - - - - - - - - - - - - - - - - - - - - - - - - -
- - 0 0 0 0 0 0 0 0 0 0 0 0 0 0 0 0 0 0 0 0 0 0 - - - - - - - - - - - - - - - - - - - - - - - - -
- - - 0 0 0 0 0 0 5 6 0 0 0 0 0 0 0 0 0 0 0 0 - - - - - - - - - - - - - - - - - - - - - - - - - -
- - - - 0 0 0 0 0 6 5 0 0 0 7 8 0 0 0 0 0 0 - - - - - - - - - - - - - - - - - - - - - - - - - - -
- - - - - 0 0 0 0 0 0 0 0 0 8 7 0 0 0 0 0 - - - - - - - - - - - - - - - - - - - - - - - - - - - -
- - - - - - 0 0 0 0 0 0 0 0 0 0 0 0 0 0 - - - - - - - - - - - - - - - - - - - - - - - - - - - - -
- - - - - - - - 0 0 0 0 0 0 0 0 0 0 - - - - - - - - - - - - - - - - - - - - - - - - - - - - - - -
- - - - - - - - - - 0 0 0 0 0 0 - - - - - - - - - - - - - - - - - - - - - - - - - - - - - - - - -
26 9 5 <-> 25 11 0
8 24 0 <-> 8 22 4
10 21 4 <-> 10 24 0
13 23 0 <-> 13 20 4
12 24 0 <-> 12 20 4
11 24 0 <-> 11 20 4
5 26 1 <-> 6 23 4
14 23 1 <-> 15 21 4
