5
10
4 2
12 30
- 0 0 0 0 0 - - - - - - - - - - - - - - 0 0 0 0 0 0 0 0 0 0
- - 0 0 0 0 0 0 0 0 - - - - - - - 0 0 0 0 0 0 0 0 0 0 0 - -
- - - 0 0 0 0 0 0 0 0 0 - - - - - - 0 0 0 0 0 0 0 0 0 - - -
- - 0 0 0 0 0 0 0 0 0 0 0 0 - - - 0 0 0 0 0 0 0 0 0 - - - -
- 0 0 0 0 0 0 0 0 0 0 0 0 0 0 0 0 0 0 0 0 0 0 0 0 0 - - - -
- 0 0 0 0 0 0 0 0 0 0 0 0 0 0 0 0 0 0 0 0 0 0 0 0 0 0 0 0 0
- - 0 0 0 0 0 5 6 0 0 0 0 0 0 0 0 0 0 0 0 0 0 0 0 0 0 0 0 -
- - - 0 0 0 0 2 3 0 0 0 0 0 0 0 0 0 0 0 0 0 0 0 0 0 0 - - -
- - 0 0 0 0 0 1 4 0 0 0 0 0 0 0 0 0 0 0 0 0 0 0 0 0 0 0 - -
- 0 0 0 0 0 0 0 0 0 0 0 0 0 0 0 0 0 0 0 0 0 0 0 0 0 0 0 - -
0 0 0 0 0 0 0 0 0 0 0 0 0 0 - 0 0 0 0 0 0 0 0 0 0 0 0 0 0 -
- 0 0 0 0 0 0 0 0 0 - - 0 - - - 0 0 0 0 0 0 0 0 0 0 0 - - -
3 3 0 <-> 12 11 4
14 4 1 <-> 28 10 2