3
3
3 3
18 18
- - - - - - - - - - - - - - - - - - 
- - - - - - - - 0 0 - - - - - - - - 
- - - - - - 0 0 0 0 0 0 - - - - - - 
- - - - 0 0 0 c 0 0 x 0 0 0 - - - - 
- - 0 0 0 0 0 0 x x 0 i 0 0 0 0 - - 
0 0 0 0 0 0 0 0 0 0 0 0 0 0 0 0 0 0 
0 0 0 0 0 0 0 0 0 0 0 0 0 0 0 0 0 0 
0 0 0 0 0 0 0 1 2 3 0 0 0 0 0 0 0 0 
- - - 0 b 0 0 2 3 1 0 0 0 0 0 - - - 
- - - 0 0 0 0 3 1 2 0 0 0 b 0 - - - 
- - - 0 0 0 0 0 0 0 0 0 0 0 0 - - - 
0 0 0 0 0 0 0 0 0 0 0 0 0 0 0 0 0 0 
0 0 0 0 0 0 0 0 0 0 0 0 0 0 0 0 0 0 
0 0 0 0 0 i 0 0 x x 0 0 0 0 0 0 0 0 
- - 0 0 0 0 0 0 x 0 0 0 0 0 0 0 - - 
- - - - 0 0 0 0 0 0 0 c 0 0 - - - - 
- - - - - - 0 0 0 0 0 0 - - - - - - 
- - - - - - - - 0 0 - - - - - - - - 
8 1 0 <-> 8 17 4
9 1 0 <-> 9 17 4
11 2 2 <-> 11 16 2
