6
6
4 2
29 28
- - - - - - - - - - - - - - - - - - - - - - - - - - - - 
- - 0 0 0 0 0 0 0 0 0 0 0 0 0 0 0 0 0 0 0 0 0 0 0 0 0 0 
- - 0 0 0 0 0 0 0 i 0 0 0 0 0 0 0 c 0 0 0 0 0 0 0 b 0 0 
- - 0 0 0 0 0 0 0 0 0 0 0 0 0 0 0 0 0 0 0 0 0 0 0 0 0 0 
- - 0 0 0 0 0 0 0 0 0 0 0 0 0 0 0 0 0 0 0 0 0 0 0 0 0 0 
- - 0 0 0 0 0 0 0 0 0 0 0 0 0 0 0 0 0 0 0 0 0 0 x 0 0 0 
- - - - - - - - - - - - - - - - - - 0 0 0 0 0 x x x 0 0 
- - 0 0 0 0 0 0 0 0 0 0 0 0 0 0 - - 0 0 0 0 0 0 0 0 0 0 
- - 0 i 0 0 0 0 0 0 0 0 0 b 0 0 - - 0 0 0 0 0 0 0 0 0 0 
- - 0 0 0 0 0 0 0 0 0 0 0 0 0 0 - - 0 0 0 0 c 0 0 0 0 0 
- - 0 0 0 1 3 5 2 4 6 0 0 0 0 0 - - 0 0 0 0 0 0 0 0 0 0 
- - 0 0 0 3 5 1 6 2 4 0 0 0 0 0 - - 0 0 0 0 0 0 0 0 0 0 
- - 0 0 0 5 1 3 4 6 2 0 0 0 0 0 - - - - - - - - - - - - 
- - 0 0 0 0 0 0 0 0 0 0 0 0 0 0 - - - - - - - - - - - - 
- - 0 0 0 0 0 0 0 0 0 0 0 0 0 0 - - 0 0 0 0 0 0 0 0 0 0 
- - 0 0 0 0 0 0 0 0 0 0 0 0 0 0 - - 0 0 0 0 0 0 0 0 0 0 
- - 0 0 0 0 0 0 0 x x x 0 0 0 0 - - 0 0 0 0 c 0 0 0 0 0 
- - 0 0 0 0 0 0 0 0 x 0 0 0 0 0 - - 0 0 0 0 0 0 0 0 0 0 
- - 0 0 0 0 0 0 0 0 0 0 0 0 0 0 - - 0 0 0 0 0 0 0 i 0 0 
- - 0 0 0 0 0 0 0 0 0 0 0 0 0 0 - - 0 0 0 0 0 0 0 0 0 0 
- - - - - - - - - - - - - - - - - - 0 0 0 0 0 0 0 0 0 0 
- - 0 0 0 0 0 0 0 0 0 0 0 0 0 0 0 0 0 0 0 x x x 0 0 0 0 
- - 0 0 0 0 0 0 0 0 0 0 0 0 0 0 0 0 0 0 0 0 x 0 0 0 0 0 
- - 0 0 0 0 0 0 0 i 0 0 0 0 0 0 0 0 0 0 0 0 0 0 0 0 0 0 
- - 0 0 0 0 0 0 0 0 0 0 0 0 0 0 0 0 0 0 0 0 0 0 0 0 0 0 
- - 0 0 0 0 0 0 0 0 0 0 0 0 0 0 0 c 0 0 0 0 0 0 0 0 0 0 
- - 0 0 0 0 0 0 0 0 0 0 0 0 0 0 0 0 0 0 0 0 0 0 b 0 0 0 
- - 0 0 0 b 0 0 0 0 0 0 0 0 0 0 0 0 0 0 0 0 0 0 0 0 0 0 
- - 0 0 0 0 0 0 0 0 0 0 0 0 0 0 0 0 0 0 0 0 0 0 0 0 0 0 
15 7 1 <-> 20 28 3
15 19 3 <-> 27 2 2
24 11 4 <-> 24 14 0
2 8 6 <-> 2 27 6
