2
5
0 0
8 8
0 0 0 0 0 0 - 0 
0 c 0 0 0 0 0 0 
0 0 0 i 0 0 0 0 
0 0 0 1 2 0 0 0 
b 0 0 2 1 c 0 0 
0 0 0 0 0 0 0 0 
0 0 0 0 0 b 0 0 
0 0 0 0 0 0 0 0 
