2
5
0 0
8 8
0 0 0 0 0 0 0 0
0 0 0 0 0 0 0 0
0 0 0 0 0 0 0 0
0 0 0 1 1 0 0 0
0 0 0 1 1 0 0 0
0 0 0 0 0 0 0 0
0 0 0 0 0 0 0 0
0 0 0 0 0 0 0 0
0 7 3 <-> 1 0 7
1 7 3 <-> 2 0 7
2 7 3 <-> 3 0 7
3 7 3 <-> 4 0 7
4 7 3 <-> 5 0 7
5 7 3 <-> 6 0 7
6 7 3 <-> 7 0 7
1 7 5 <-> 0 0 1
2 7 5 <-> 1 0 1
3 7 5 <-> 2 0 1
4 7 5 <-> 3 0 1
5 7 5 <-> 4 0 1
6 7 5 <-> 5 0 1
7 7 5 <-> 6 0 1
7 0 3 <-> 0 1 7
7 1 3 <-> 0 2 7
7 2 3 <-> 0 3 7
7 3 3 <-> 0 4 7
7 4 3 <-> 0 5 7
7 5 3 <-> 0 6 7
7 6 3 <-> 0 7 7
7 1 1 <-> 0 0 5
7 2 1 <-> 0 1 5
7 3 1 <-> 0 2 5
7 4 1 <-> 0 3 5
7 5 1 <-> 0 4 5
7 6 1 <-> 0 5 5
7 7 1 <-> 0 6 5
7 7 3 <-> 0 0 7
0 7 5 <-> 7 0 1
0 7 4 <-> 0 0 0
1 0 0 <-> 1 7 4
2 7 4 <-> 2 0 0
3 0 0 <-> 3 7 4
4 0 0 <-> 4 7 4
5 7 4 <-> 5 0 0
6 0 0 <-> 6 7 4
7 7 4 <-> 7 0 0
7 0 2 <-> 0 0 6
0 1 6 <-> 7 1 2
7 2 2 <-> 0 2 6
0 3 6 <-> 7 3 2
0 4 6 <-> 7 4 2
7 5 2 <-> 0 5 6
0 6 6 <-> 7 6 2
7 7 2 <-> 0 7 6

